castle
forest
0
0
0
30
37
11111111111111111111111111111111111111
11111111111111111111111111111111111111
11111111111111111111111111111111111111
11111111111111111111111111111111111111
11111111111111111111111111111111111111
11111111111111111111111111111111111111
11111111111111111111111111111111111111
11111111111111111100111111111111111111
11111111111111110000111111111111111111
11111111111111100000111111111111111111
11111111111111111000111111111111111111
11111111111111111000111111111111111111
11111111111111111011111111111111111111
11111111111111111011111111111111111111
11111111111111111011111111111111111111
11111111111111111011111111111111111111
11111111111111111011111111111111111111
11111111111111111011111111111111111111
11111111111111111011111111111111111111
11111111111111111011111111111111111111
11111111111111100000111111111111111111
11111111111111111000111111111111111111
11111111111111111100001111111111111111
11111111111111111111000011111111111111
11111111111111111111111000111111111111
11111111100001111111111110001111111111
11111111000001111111111100000111111111
11111111110000000000000000011111111111
11111111111100000000000001111111111111
11111111111111000000000111111111111111
bluekey
3
key1
9
29
15
description
You've arrived at a huge castle.. Bet you need a key to get inside..
object
Gate of Winning
Ring of Doom
gate1
15
17
creatures
Npc
A hot princess
8
17
princess
