desert
start
mountain
0
0
20
20
10000000000000000011
11100000000000000111
10000000000000000011
00000000000000000000
00000000000000000000
00000000001111000000
00000000000111000001
11000000000000000011
11100000000000000111
11100000000000000111
10000000000000000111
10000000000000000111
10000000000000000111
10000000111000000111
10000001111100000111
10000000000000000111
10000001111100000111
10000000000000000111
10000000000000000111
10000000000000000111
helm
15
15
10
description
This wasteland is called the Glass desert, the sand seems to be made of sharp crystals, watch your step! But to the north you can still see the lonely mountain...
