forest
0
castle
start
0
20
20
10000000000000000011
11100000000000000111
10000000000000000011
00011000000000000001
00000000000000000001
00000000001111000001
00000010000111000001
00000000000000000011
00001000000000000111
00000000010000000111
00000000000000000111
10000010000100000111
10000000000000100111
10000000111000000111
10000001111100000111
10000000000000000111
10000001111100100111
11000000000000000111
11100001100010000111
11111111111111111111
Armor
15
armor
40
15
10
description
You've entered a great forest.. Try to find your way out!
creatures
Bat
Wild bat
8
8
bat
