home
0
start
0
0
10
11
11111011111
10000000001
10000000001
10000000001
10000000001
10000000001
10000000001
10000000001
10000000001
11111111111
description
This is your home, it is probably where you live.
