normal
0
desert
ocean
forest
20
10000000000000000011
10000000011000000011
11100000000000000111
10000000000000000011
00000000000000000000
00000000000000000000
00000000001111000000
00000000000111000001
11000000000000000011
11100000000000000111
11100000000000000111
10000000000000000111
10000000000000000111
10000000000000000111
10000000000000000111
10000000000000000111
10000000000000000111
10000000000000000111
10000000000000000111
10000000000000000111
10000000000000000111
helm
15
10
10
sword
20
13
4
description
This is a plain field of roses. But far to the north you can see a lonely mountain...